----------
-######---
-#<#####--
-#^#^###--
--#--####-
--#---^##-
-##^^-^#^-
-####^#>#-
--##--^#^-
----------