----------
-<#######-
-########-
-########-
-########-
-########-
-########-
-########-
-#######>-
----------