----------
-<#^^^^^#-
-########-
-^^-##-^^-
-^^####^^-
-^^####^^-
-^^-##-^^-
-########-
-#^^^^^#>-
----------